................b...
...............___..
....................
....................
...b................
..___...............
........p...........
....................
................b...
...............___..
....................
....................
.............e......
....................