....................
....................
....................
....................
....................
....................
....................
....................
........p...........
..b.......b......b..
..___...___....___..
....................
.............e......
____________________