....................
.........b..........
......________......
....................
....................
....................
....................
...b.....p......b...
..____........____..
....................
....................
....................
...e................
____________________