....................
....................
....................
....................
....................
....................
....................
.........p..........
....................
....................
....................
....................
...e................
____________________