................b...
...............___..
....................
....................
...e................
..___...............
........p...........
....................
................b...
...............___..
....................
....................
....................
____________________