....................
................b...
...............___..
....................
....................
..e.................
..___...............
....................
....................
.................b..
...............___..
....................
....................
....p...............
____________________